11111111111111111111111111111111111111111111111111111111111
10000000000000000000000000000000000000000000000000000000001
10000000000000000000000000000000000000000000000000000000001
10000000000000000000000000000000000000000000000000000000001
10000000000000000000000000000000000000000000000000000000001
10000000000000000000000000000000000000000000000000000000001
10000000000000000000000000000000000000000000000000000000001
10000000000000000000000000000000000000000000000000000000001
10000000000000000000000000000000000000000000000000000000001
10000000000000000000000000000000000000000000000000000000001
10000000000000000000000000000000000000000000000000000000001
10000000000000000000000000000000000000000000000000000000001
10000000000000000000000000000000000000000000000000000000001
100P0000000000000000000000000000000000000000000000000000001
10000000000000000000000000000000000000000000000000000000001
1000000G000000000000000000000000000000000000000000000000001
10011111000000000000000000000000000000000000000000000000001
10000000000000000000G0000000000000000000000000000000000G001
10000000000000001111111111111100000000000000000000000011111
11111111111111111111111111111111111111111111111111111111111