1111111111111111111111111111111111111111111111111111111111111111111111111111111111111111111111111111111111111111111111
1000000000000000000000000000000000000000001000000000000000110000000000000000000000000000000000000000010000000000000001
1000000000000000000000000000000000000000001000000000000000110000000000000000000000000000000000000000010000000000000001
1000000000000000000000000000000000000111111000000000000000110000000000000000000000000000000000001111110000000000000001
1000000000000000000000000000000000000000000000000000000000110000000000000000000000000000000000000000000000000000000001
1000000000000000000000000000000000000000000000000000000000110000000000000000000000000000000000000000000000000000000001
1000000000000000000000000000000000000000000000000000000000110000000000000000000000000000000000000000000000000000000001
1000000000000000000000000000000000000000000000000000000000110000000000000000000000000000000000000000000000000000000001
1000000000000000000000000000000000000000000000000000000000110000000000000000000000000000000000000000000000000000000001
1000000000000000000000000000000000000000000000000000000000000000000000000000000000000000000000000000000000000000000001
1000000000000000000000000000000000000000000000000000000000000000000000000000000000000000000000000000000000000000000001
1000000000000000000000000000000000000000000000000000000000000000000000000000000000000000000000000000000000000000000001
1000000000000000000000000000000000000000000000000000000000000000000000000000000000000000000000000000000000000000000001
100P000000000000000000000000000000000000000000000000000000000000000000000000000000000000000000000000000000000000000001
1000000000000000000000000000000000000000000000000000000000110000000000000000000000000000000000000000000000000000000001
1000000G0000000000000000000000000000000000000000000000000011000000G000000000000000000000000000000000000000000000000001
1001111100000000000000000000000000000000000000000000000000110011111000000000000000000000000000000000000000000000000001
10000000000000000000G0000000000000000000000000000000000G00110000000000000000000G0000000000000000000000000000000000G001
1000000000000000111111111111110000000000000000000000001111110000000000000001111111111111100000000000000000000000011111
1111111111111111111111111111111111111111111111111111111111111111111111111111111111111111111111111111111111111111111111